XXXSXXXXXX
X     X  X
X XXXXX XX
X     X XX
XX XX    X
X   XXXX E
XXXXXXXXXX
