XXXXSXXXXXXXEX
XXXX XXXXXXXXX
X  X X       X
X X  X XXXXX X
X X XX       X
X   XX XXX XXX
XXX    XXX   X
XXXXXXXXXXXXXX
